36
36
111111111111111111111111111111111111
100000000011000000000000000000000001
100000000011000000000000000000000001
100000000011000000000000000000000001
100000000011000000000000000000000001
100000000011000000000000000000000001
1000000000A0000000000000000000000001
100000000000000000000000000000000001
1000000000110000000000000B0000000001
100000000011000000000000000000000001
111111111111111111111111001111111111
111111111111111111111111001111111111
100000000000000000000000000000000001
100000000000000000000000C00000000001
10D000000000000000000000000000000001
110011111111111111111111111111111111
110011111111111111111111111111111111
100E00000000000000000001100000000001
100000000000000000000001100000000001
100000000000000000000001100000000001
100000000000000000000001100000000G0X
100000000000000000000001100000000001
100000000000000000000001100000000001
100000000000000000000001100000000001
100000000000000000000001100000000001
100000000000000000000001100000000001
100000000000000000000001100000000001
100000000000000000000001100000000001
100000000000000000000001100000000001
100000000000000000000001100000000001
100000000000000000000001100000000001
100000000000000000000001100000000001
100000000000000000000000000000000001
100000000000000000000000F00000000001
100000000000000000000001100000000001
111111111111111111111111111111111111