36
36
1111>111111111111111111>111111111111
100000000011000000000000000000000001
100000000011000000000000000000000001
1000000000v1000000000000000000000001
10000000001v00000000000000000000000v
100000000011000000000000000000000001
100000000000000000000000000000000001
1000000000*0000000000000000000000001
10000000001>00000000000000000000000v
100000000011000000000000000000000001
1111>111111111111>111>11*011111<11<1
111<111111<1111111111<1100v111111111
100000000000000000000000000000000001
v00000000000000000000000000000000001
100000000000000000000000000000000001
110*111111111<11111111111<1111<11111
1v001111>111111>11111111111>11111111
10000000000000000000000110000000000v
v00000000000000000000001100000000001
10000000000000000000000v100000000001
10000000000000000000000110000000000X
100000000000000000000001^00000000001
v00000000000000000000001100000000001
10000000000000000000000v100000000001
10000000000000000000000110000000000^
100000000000000000000001^00000000001
100000000000000000000001100000000001
v00000000000000000000001100000000001
10000000000000000000000v100000000001
100000000000000000000001100000000001
100000000000000000000001^0000000000^
10000000000000000000000>100000000001
100000000000000000000000000000000001
v0000000000000000000000*000000000001
10000000000000000000000^>00000000001
111>1111>11>11>11111>111111111>11111