36
36
111111111111111111111111111111111111
100000000011000000000000000000000001
100000000011000000000000000000000001
100000000011000000000000000000000001
100000000011000000000000000000000001
100000000011000000000000000000000001
100000000000000000000000000000000001
100000000000000000000000000000000001
100000000011000000000000000000000001
100000000011000000000000000000000001
111111111111111111111111001111111111
111111111111111111111111001111111111
100000000000000000000000000000000001
100000000000000000000000000000000001
100000000000000000000000000000000001
110011111111111111111111111111111111
110011111111111111111111111111111111
100000000000000000000001100000000001
100000000000000000000001100000000001
100000000000000000000001100000000001
100000000000000000000001100000000002
100000000000000000000001100000000001
100000000000000000000001100000000001
100000000000000000000001100000000001
100000000000000000000001100000000001
100000000000000000000001100000000001
100000000000000000000001100000000001
100000000000000000000001100000000001
100000000000000000000001100000000001
100000000000000000000001100000000001
100000000000000000000001100000000001
100000000000000000000001100000000001
100000000000000000000000000000000001
100000000000000000000000000000000001
100000000000000000000001100000000001
111111111111111111111111111111111111