10
10
1111111111
1000011001
1000011001
1000011001
1100000001
1100110001
1001111101
1011000101
1110000001
1111111111