10
10
1111111111
1000011001
1000011001
1000011001
11000A0001
11001100B1
1001111101
1011000101
111D0000C1
111X111111