36
36
111111111111111111111111111111111111
1000000000110000110000D0000000000001
1000000000110000110000000000000000E1
100000000011000011000011111111110001
1000000000110000B00000110000000000F1
100000000011000011000011G00000000001
1000000000A0000011000011001111111111
1000000000000000C0000011000000000001
100000000011000011000011000000000001
100000000011000011000011000000000001
111111111111111111111111001111111111
111111111111111111111111001111111111
100000000000000000000000000000000001
100000000000000000000000H00000000001
10I000000000000000000000000000000001
110011111111111111111111111111111111
110011111111111111111111111111111111
100000000000000000000001100000000001
10J000000000000000000001100000000001
100000000000000000000001100000000001
100000000000000000000001100000000L0X
100000000000000000000001100000000001
100000000000000000000001100000000001
100000000000000000000001100000000001
100000000000000000000001100000000001
100000000000000000000001100000000001
100000000000000000000001100000000001
100000000000000000000001100000000001
100000000000000000000001100000000001
100000000000000000000001100000000001
100000000000000000000001100000000001
100000000000000000000001100000000001
100000000000000000000000000000000001
100000000000000000000000K00000000001
100000000000000000000001100000000001
111111111111111111111111111111111111